....................................
....................................
....................................
...11111.e.1..1.....1111..1.....1...
...1....1..1..1.....1......1...1....
...1....1..1..1...e.1.......1.1.....
...11111...1..1.....1111.....1......
...1..1....1..1.....1.....e..1......
...1...1...1..1.....1........1......
...1....1p.1..1111..1111.....1......
........e...............e...........